La vie en rose - How I Met Your Mother
Take a Hint - Victorious
Shallow - Ha nacido una estrella
Savages / Barbaros - Pocahontas
All the way to Dublin - Sinners
Show me how you burlesque - Burlesque
Mr. Mistoffeles - Cats
You're Welcome - Moana/Vaiana
My favorite things - Sonrisas y lágrimas
La Senda - Agatha ¿Quién si no?
This wondering day - The rings of Power cap 1x05
Bella Notte - La dama y el vagabundo
Afterlife - Devil may cry
I lied to you - Sinners
Stronger than you - Steven Universe
Through heaven’s eyes - The Prince of Egypt
From now on - The Greatest Showman
Dos oruguitas - Encanto
Kickapoo - Tenacious D in the Pick of Destiny
Double trouble - HP y el prisionero de Azkaban
Don't Stop Believing - Glee
We are number one - Lazy Town
Black Sheep - Scott Pilgrim
Rewrite the stars - The Greatest Showman
Infierno Robot - Futurama
Decode - Paramore
Does you mother know? - Mamma Mia
Inspiración - Encanto (inglés)
Nos manifestaremos - Los Simpsons
Do the hippogriff - Harry Potter and the goblet of fire.
Part of your world - The little mermaid
All for us - Zendaya & Labrinth
9 Crimes - Shrek 3
Qué festín - La Bella y la Bestia
Quiero ser como tu - El libro de la selva
Bet on it - High School Musical 2
The climb - Hannah Montana
The Moon Song - Her
I’ll never love again - Ha nacido una estrella
Toss a coin to your witcher - The Witcher
Mi sueño es - Enredados
The Boy Who Wouldn't Hoe Corn - The Broken Circle
Maneater - No Hard Feelings
It's my life/confessions - Glee
Double Trouble - Eurovision Song Contest
Rock Got No Reason - School of rock
Master of the house - Les Misérable
Cruella de Vil - 101 Dálmatas
How it’s done - Guerreras K-pop
Can’t catch me now - The hunger games
Riff off - Pitch Perfect 3 (Lyrics).
Q&A (escuchar esta) - Date A Live
Solo quedate en silencio - RBD, Rebelde
Honra nos darás - Mulán
Hazme un muñeco de nieve - Frozen
Todas las flores - La llamada
Demon in your Dreams - WWE
Can’t stop the feeling - Trolls
Where you are - Moana/Vaiana
Voy a ser el Rey León - El Rey León
¡Ya Basta! - Phineas y Ferb
No es lo que yo llamo - La princesa cisne
Mambo Burns - Los simpsons
La historia de Danny - Phineas y Ferb
Take on me - A ha. Deadpool 2.
Me diste alas - La espada mágica
Canción de las patatas - Hora de aventuras
Feel It - d4vd (Invincible)
En la jungla - El rey león
Funeral - Ted Lasso
Cooking By The Book - Lazy Town
San Francisco - The last black man in San Francisco.
Breaking free - High School Musical
The Greatest Show - The Greatest Showman
Topsy Turvy - El jorobado de Notre Dame
Volaré - Brave
Nothing suits me like a suit - HIMYM
Lay all your love on me - Mamma Mia
Happy Together - The Penguin
What Dreams are made of - Lizzie Superstar
Canción del club del herrete - Phineas y Ferb
La Bella y la Bestia - La Bella y la Bestia
Sunflower - Spiderman
My freeze ray - Dr Horrible Sing-along blog
Asalto al castillo - La bella y la Bestia
New Genesis - One Piece Red
Heathens - Suicide Squad
He lives in you (escena) - The Lion King 2.
Pobres almas en desgracia - La sirenita
Madre sabe más - Enredados
Screw you - Scrubs interne
Torture Dance - Jojo’s: Part 5
My Eyes - Dr. Horrible Sing-Along Blog. Lyrics
El fantasma de la Ópera - El fantasma de la Ópera
Pitch perfect 2 - flashlight
Our last summer - Mamma mia!
Galavant - Galavant
Bibidi-babidi-bu - Cenicienta
Brand New Day - Dr. Horrible Sing-Along Blog
Comedy - Bo Burnham’s Inside
God Knows - The Melancholy of Haruhi Suzumiya
Spin The Wheel - Arcane 2
I like to move it - Madagascar
Jodido, tío - Hazbin Hotel
Mi última esperanza - Hércules