Is She Still With You - Batman v Superman
Leaving Caladan - Dune Parte I
Attack on titan - Ataque a los titanes
Il triello - El bueno, el feo y el malo
Tanjiro no Uta - Kimetsu no Yaiba
Death of Sirius - Harry Potter y la Orden del Fénix
David el Jones tema - Piratas del Caribe: El Cofre del Hombre Muerto
"Carros de fuego" - Vangelis (Carros de fuego)
Rain - Cowboy bebop
To the Infinity Castle - Kimetsu No Yaiba
Once there was a Hushpuppy - Bestias del Sur Salvajes
Living in the shadows - Love, death and robots
Now We Are Free - Gladiator
One Day - Piratas del caribe 3 - Piratas del Caribe, en el fin del mundo
This Land - El Rey León
Sanctuary - The Hunchback of Notre Dame
Vértigo - Vértigo
Lex Luthor theme - Batman v Superman: Dawn of Justice
Restriction and pledge - Hunter x Hunter
Test Drive - Como entrenar a tu dragón
Jump in the line - Beetlejuice
Goodbye blue sky - The Wall
Dynasties & Dystopia - Arcane
The Breaking of the Fellowship (feat. "In Dreams") - El señor de los anillos
Kiss the ring - Dune Parte II
Overture - The phantom of the Opera
The Night King - Juego de Tronos
Love theme - Cinema Paradiso
Lisan Al Gaib - Dune II
Courtyard Apocalypse - Harry Potter
Nana de Mercedes - El laberinto del fauno
Apocalypto - The Game and Scape
Moon Knight theme - Moon Knight
True survivor- Kung fury
Blade runner blues - Blade Runner
Still don't know my name - Euphoria
The Game is On - Sherlock
I am Sherlocked - Sherlock
Duel of Fates - Star Wars: La Amenaza Fantasma
Náufrago escena- Náufrago
Imhotep - The mummy
Unohana Bankai - Bleach
Hymn To Red October - La caza del octubre rojo
La Pantera Rosa - La Pantera Rosa
Mother Sea - One piece
The bridge of Khazad Dum - El señor de los anillos
Jurassic Park - Parque Jurásico
Piratas del caribe BSO - Piratas del Caribe
Binary Sunset (Force Theme) - Star Wars: Una Nueva Esperanza
Freedom - Braveheart
Master of Masters theme - Kingdom Hearts
Discombobulate - Sherlock Holmes
Victor’s piano solo - La novia cadáver
The Only thing worth fighting for - True Detective
Marcha imperial - Star wars
Sayuri's Theme - Memorias de una Geisha
Your new home - Amazing Digital Circus
Love so fine - True Beauty kdrama
The Citrine Cross - The Da Vinci Code
Eye of the tiger - Rocky III
Kronos Unveiled - Los Increíbles
Farewell - Pocahontas
Family theme - Shinchan
Alice’s Theme - Alicia en el País de la Maravillas
Enchantix - Winx Club
Vals - Princesa por sorpresa
Locke’d out again - Lost
Spirit - No voy a rendirme
Mazinger Z Fight theme - Escena de Mazinger Z vs Devilman
Change of seasons - Harry Potter y la piedra filosofal
Indiana Jones Theme - Indiana Jones
Kanto Anime OST - Pokemon
Married Life - Up
Escena final Titanic - Titanic
Battle of the Heroes - Star Wars: La Venganza de los Sith
Hyoga vs Camus - Saint Seiya
My Daughter Anne - Anne with an E
She is a witch - Madoka Magica
Sweet Dreams - Chainsaw man
Main theme - Psycho/Psicosis
The Batman - The Batman
Pozos de ambición - There will be blood
Portals - Avengers Endgame
I have to save her - Erased
The Mandalorian theme - The Mandalorian
Khazad-dûm - El Señor de los Anillos: Los Anillos de Poder
Tituless - Rebel Moon: El Cáliz de Sangre (Director's Cut)
Isshiki japanese combat kitchen - Shokugeki
Happy Gru - Gru, mi villano favorito
Escena Rue - Los juegos del hambre
Zorro´s Theme - La mascara del zorro
Lo que el viento se llevó - Lo que el viento se llevó
Season 5A Suite - Once Upon a Time
Parade - Paprika
Derezzed - Tron legacy
Low of Solipsism - Death Note
Destroyer of Worlds - Oppenheimer
Sin mirar atrás - La ruta hacia el dorado
Corazón de dragón tema final- Corazón de dragón
To give a marionette life - Hunter x Hunter
A Watchful Guardian - The Dark Knight
Allerdale Hall - La Cumbre Escarlata
Hanezeve Caradhina - Made in Abyss
The Other Side - Gattaca
I think i did - Lovely runner
Love theme - El padrino
Jaws, Main Theme - Jaws
Theme from Schindler’s List - Schindler’s List
Transformación - Hermano Oso
A Gift of A Thistle - Braveheart
Surrounded - El hombre de la máscara de hierro
Mischief Managed - Harry Potter y el Prisionero de Azkaban
Dumbledore’s farewell - Harry Potter y el misterio del príncipe
An Immortal conffesion - Fumetsu no anata e.
Table for two - Animales Nocturnos
Cuckold Comes Out - Master & Commander
Lo extraño que soy - Tarzán
Pinks Soldiers 23 - Juego del calamar
Twin Peaks - Twin Peaks
Main title - El resplandor
Ashoka vs Maul - Star Wars: Clone Wars
The Wolf Who Became A Woman - Rebel Moon: Parte 1
Bso Leyendas de pasión- Leyendas de pasión
Sauron - El señor de los anillos: Los Anillos de Poder
Madder Sky - Code Geass
Rengoku vs Akaza - Kimetsu no Yaiba
Sadness Waltz - The picture of Dorian Gray
The Ecstasy of gold - El bueno, el feo y el malo
She will kill you - Stranger things
La vita è Bella - La Vita è Bella
Death is the road to Awe - The Fountain
The rains of Castamere - Juego de Tronos